Anglija - England
Albanija - Albania
Alžirija - Algeria
Argentina - Argentina
Armenija - Armenia
Avstrija - Austria
Belgija - Belgium
Brazilija - Brazilija
Bosna in Hercegovina - Bosnia & Herzegovina
Češka - Czech Republic
Čile - Chile
Črna Gora - Montenegro
Danska - Denmark
Dominikanska Republika - Dominican Republic
Egipt - Egypt
Ekvador - Ecuador
Francija - France
Finska - Finland
Gabon - Gabon
Gana - Ghana
Grčija - Greece
Gvineja - Guinea
Hrvaška - Croatia
Italija - Italy
Jamajka - Jamaica
Japonska - Japan
Južna Koreja - South Korea
Kamerun - Cameroon
Kenija - Kenya
Kolumbija - Colombia
Kostarika - Costa Rica
Madžarska - Hungary
Maroko - Morocco
Nemčija - Germany
Nigerija - Nigeria
Nizozemska - Netherlands
Poljska - Poland
Portugalska - Portugal
Rusija - Russia
Senegal - Senegal
Slonokoščena obala - Ivory Coast
Slovaška - Slovakia
Slovenija - Slovenia
Srbija - Serbia
Škotska - Scotland
Španija - Spain
Švedska - Sweden
Švica - Switzerland
Turčija - Turkey
Urugvaj - Uruguay
Wales - Wales
